1111111111111111111111111
1P00001000001000001000001
1011101011101011101011101
1000001000001000001000001
1110111110111110111110111
1000100000000000001000001
1011101111111111101011101
1000000000000000000000001
1111101111111111101111101
1000C010000000000010C0001
1011111011111110111111101
1000000010000010000000001
1111111011111110111111111
1C000000000000000000000C1
1011111111101111111111101
1000000000101000000000001
1111111110111011111111111
1000C00000000000000C00001
1011101111111111111011101
1000101000000000001010001
1110101011111110101011101
1000000010000000100000001
1111111110111110111111111
1000000000100000100000001
1011111111101110111111101
1C000000000000000000000E1
1111111111111111111111111
